NO textures/no.xpm
SO textures/so.xpm
WE textures/we.xpm
EA textures/ea.xpm

F 238,223,204
C 255,218,233

1111111111111111111111111111111111
1110000000000000000011000000000001
1010110000011100000000000000000001
1111000000000000000000000000000001
1111111101100000111000000000000001
1000000000110000011101111111110011
1111011111111101110000001000000001
1111011111111101110101001000000001
11000000110101011100S0000000001001
1000000000000000110000001000000001
1000000000000000110101001000000001
1100000111010101111101111000000011
1111011101110101110111101000000001
1111111111111111111111111111111111